#######################################
#                                     #
#             ?                       #
#&&         ----------           -----#
#&& /               |                 #
#-----------------------              #
#                |                    #
#             ------------------------#
#                      |              #
#------------------    |              #
#                      |              #
#                 --------------------#
#          $                    |     #
#------------------------       |     #
#                               |     #
#            -------------------------#
#                      |              #
#                      |              #
#                -------------------- #
#@   *                          |     #
#######################################