##################
#BB      P    |  #
#BB D   ---      #
#-----   --------#
#           |    #
# ---------      #
#    |         H #
#        --------#
#O   M       |   #
##################