##################
#&&      ?       #
#&& /   ---      #
#-----   --------#
#           |    #
# ---------      #
#    |         $ #
#        --------#
#@   *       |   #
##################