#####################
#&&      ?    |     #
#&& /   ---         #
#-----   --------   #
#    &      |       #
# ------------      #
#    |              #
#    |   --------   #
#           |       #
#           |       #
#    ---------------#
#   |               #
#   |               #
#   |               #
#   |               #
#  ----         $   #
#      ------------ #
#            |      #
#@   *   &   |      #
#####################