#####################
#   /     ?         #
# ---   ---         #
#        |          #
#----  ----------   #
#  +        |       #
# ------------      #
#    |              #
#    |              #
#   -------------   #
#           |       #
#           |    +  #
#   ----------------#
#   |               #
#   |               #
#   |               #
#  -----        $   #
#      |            #
#      ------------ #
#            |      #
#@   *       |    + #
#-------------------#
#####################