#####################
#   /     ?         #
# ---   ---         #
#        |          #
#----  ----------   #
#           |       #
# ------------      #
#    |              #
#    |              #
#   -------------   #
#           |       #
#           |       #
#   ----------------#
#   |               #
#   |               #
#   |               #
#  -----        $   #
#      |            #
#      ------------ #
#            |      #
#@   *       |      #
#-------------------#
#####################